R 2000 2000
NO ../textures/bluestone.xpm
SO ../textures/colorstone.xpm
WE ../textures/eagle.xpm
EA ../textures/mossy.xpm
S ../textures/barrel.xpm
F 255,255,255
C 0,0,0


        1111111111111111111111111
        10000000001100000000000001
        10110000011100000020000001
        1001000000000000000000001
1111111110110000011100000000000001
1000000000110000011101111111111111
111111111111111111111111111111111111111111111111111
111111111111111111111111111111111111111111111111111
1110111111111011100000010001
11110111111111011101010010001
11000002110101011100000010001
10002000000202021100000010001
1000000E000000001101010010001
1100000111010101111101111000111
11110111 1110101 101111010001
11111111 1111111 111111111111